1111111111111111111111111111111111111111111111111111111111111111111111111111111111111111111111111111111111111111111111111111111111111111111111111111111111111111111111111111400000000000006111111111111111111111111111111111111111111111111111111111111111111111111111111111111111111111111111111111111111111111111111111111111111111111111100111111111111111111111111111111111111110000200000000071111111111111111111111111011111111111111111111111111111111111111101111111111111111111111111111111111111100111111111111111111111111111111111111110000000000000003111111111111111111111111111111111111111111111111111111111111111111111111111111111111111111111111111111111111111111111111111111111111111111111111111111111111111111111111111111111111111111111111111111111111111111111111111111111111111111111111111111111111111111111111111111111111111111111111111111111111111111111111111111111111111111111
1111111111111111111111111111111111111111111111111111111111111111111111111111111111111111111111111111111111111111111111111111111111111111111111111111111111111111111111111111111114111111111111111111111111111111111111111000611111111111111111111111111111111111121111100111111111111111111111111111111000000000011111111111111111111111111111101111111001111111111111111111111111111100011111100111111111111111111111111111110701111110311111111111111111111111111111111111111111111111111111111111111111111111111111111111111111111111111111111111111111111111111111111111111111111111111111111111111111111111111111111111111111111111111111111111111111111111111111111111111111111111111111111111111111111111111111111111111111111111111111111111111111111111111111111111111111111111111111111111111111111111111111111111111111111111111111111111111111111111111111111111111111111111111111111111111111111111
1111111111111111111111111111111111111111111111111111111111111111111111111111111111111111111111111111111111111111111111111111111111111111111111111111111111111111111111111111111111111111111111111111111111111111111110001111111110001111111111111111111111132023111111111320231111111111111111111111611011111111101161111111111111111111111111100000000000111111111111111111111111111111100470001111111111111111111111111111111000000000001111111111111111111111111161101111111110116111111111111111111111132023111111111320231111111111111111111111100011111111100011111111111111111111111111111111111111111111111111111111111111111111111111111111111111111111111111111111111111111111111111111111111111111111111111111111111111111111111111111111111111111111111111111111111111111111111111111111111111111111111111111111111111111111111111111111111111111111111111111111111111111111111111111111111111111111
1111111111111111111111111111111111111111111111111111111111111111111111111111111111111111111111111111111111111111111111111111111111111111111111111111111111111111111111111111111114111111111111111111111111111111111111111011111111111111111111111111111111111111101111111111111111111111111111111111111110000000000000000611111111111111111111111111111111111110111111111111111111111111111111311111111211111111111111111111111111111101111111101111111111111111111111111111110111111110111111111111111111111132003000000000000071111111111111111111111000011101111111101111111111111111111111111011110000002000111111111111111111111111101111001111111111111111111111111111111116111111111111111111111111111111111111111111111111111111111111111111111111111111111111111111111111111111111111111111111111111111111111111111111111111111111111111111111111111111111111111111111111111111111111111111111111111111
11111111111111111111111111111111111111111111111111111111111111111111111111111111111111111111111111111111111111111111111111111111111111111111111111111111111111111111111111111111141111111111111111111111111111111111111110111111111111111111111111111111111111111011111111111111111111111111111111111111100000000000000006111111111111111111111111111111111111101111111111111111111111111111113111111112111111111111111111111111111111011111111011111111111111111111111111111101110011101111111111111111111111320030002000000000711111111111111111111110000111011131111011111111111111111111111110111100000020001111111111111111111111111011110011111111111111111111111111111111161111111111111111111111111111111111111111111111111111111111111111111111111111111111111111111111111111111111111111111111111111111111111111111111
1111111111111111111111111111111111111111111111111111111111111111111111111111111111111111111111111111111111111111111111111111111160002020202024202020202000611111111111111102020202020202020202020111111111111111111020202020202020202020111111111111111111120202020202020202020211111111111111111110202020202020202020201111111111111111111202020202020202020202111111111111111111002020202020202020202001111111111111116002020202020202020202020061111111111111111111111111111111111111111111111111111111111111111111711111111111111111111111111111111111111101111111111111111111111111111111111111110111111111111111111111111111111111111111211111111111111111111111111111111111111101111111111111111111111111111111111111113111111111111111111111111111111111111111111111111111111111
